############
#.#........#
#.#.######.#
#.#....#...#
#.###.*#.#.#
#...##.#.#.#
#.#.#..#.#.#
#.#.#.##.#.#
#o#......#.#
############