##################################
#o...............................#
#..###########.###################
#......#.........................#
#...#..#..########################
#####..#........#...........#....#
#......#....#..........#.#.....#.#
########################.#########
#*#....................#.........#
#.#.####..####...###...#..#..##..#
#.###........#.........#..#......#
#...#..####..#..########..########
###.#........#............#...#..#
#...####..##############....#...##
#.#..........#............#...#..#
#.################..##############
#...............................*#
##################################