#####################################################################################################
#.#.#..##..#.#.#.#..#.#...##.....#..#..##.#..#.###..#.#...#.#....##.....#...##...#.#.#.##...#..#...##
##.o##..#.#.#...##.#.####.##..#.##.##..##....#..#.#...#.##.##.###..##.##.##..###..#.#...###.#.##...##
##..#..#....#.###..#..#.#....##.#.#.#.#.###..##.#..##..#.#.#..#.##.##..#.##..#.#..#.###.#....##.#.#.#
##.#...##.##.#.##..###....#..###..#.....#..###.#..#.###..###...###....#.#..#..#.###..#...##..##..##.#
##...##.#..##.#..#..##.####.#.##.#######.##.#..###...##....#####..#.##..#..###...#...###.###..##.#..#
#.....#.###.##..#..#.#..##.#.....###...###..#.#..##..#.###.###..#.#..#####....###.#.##..#.##.###.#.##
#.####.#.##..#.##..###.#..#.#####...#...#..##.#..#..##...###.#.#...##.##..######...#.#.###..#.##.#..#
#.##...##.#..##.##.##..#....#.#.###.#.##...##.####...#..#.#.#..#.....#.#...#..#..#.##.#..#..#.##.#..#
#..#.#.#.#..##.#..#..###.##.##..#..#.###.#.#..#.#.#.##.##...##..####..##....#.#....##.#.##.#....#..##
#..#..##.#.#.#..##...###..###.#.#.##..#.#..#.###.#....#.#.###.##.##..##...#.#####.......#.##.###.#..#
#...#..##..#..#.##.#.#..#.##.#...##.##.#.#.#.##....#####..#.#..##..#.########..#.##.#.##.#..#.##....#
#.###..##.#.#....###......#.#.#.#.#...##.#.....###.#.#..##...##.#.##.#...#.##.#.#.###..###..#.#.#.#.#
###.#.#.####..#..#..#####.#.#...#..##.#.##.###..##..#..........#.##..#.##..#...#.###....#..#.##.###.#
#.#.##....##..####...###.##.####..##.#.#.##.#.###.#..######.#.##...##.##...####...##..###....###.#..#
#..##..###..#.#.##..##..#...#.#.##...#..#....###...#.##..#.###.#....#..##.##.#..##.#####..##.#.###..#
##..##.##.###.#..#....##.##.##....#..##..##.#...####...##..#...##.#.#..#..#.#.#....##.#..#.###.#....#
##..#.##..#.###.##.###.#.#...####...#..#.#######.#..###..##.#..#..####..##.#.##.###.#.###..##..####.#
#..#...#.#..#.###.##..#.##.....#..###..#...#.##...#.##.#...###..###..#.#...........#...#...#.#.#.####
#.#.#.#.##.#...#...##..##.#.###.#..#####......###..##....##.#.#..##.##..###.#.######....#..#..#.#.#.#
##.###.##...###...#.#.....#.#.##..##...####.####..#.#.#.#..###.##..#...##..###.##.##..###..###..##..#
##....#.#.##.#.###....###.#.##.#..#.#.#..#..##...#.##.#....#.#..##.####.##..#.##.#...#.###.#.##....##
##.##.#.#..##..##.#.#.##...#.#.###.##.....##...#...#.####..###..#....#.###....##..###..###..##.##...#
#.#..##.#...##..#...#..###..#.##..#...###.#.....##...##.####.#...##..##..#####.###.....#.#.###....#.#
#...##....##..#...######.#..#..#.##.####.####.#.#.#..##..###.#...##..##..###...##.#.##.##.##.#.##.###
#.#.##..#..#########...#..###..##..#..#.#...#.#.#.##.###..#....#..#.#..#.#..#..#.#...#...#.##.#..#.##
#.####.##.#.#....###..#.##.#.#.#.##.#.#.###.###..##..###...##.##..####..#.#.#.#.#.####...#..##.#.#..#
##.#..#.#.#.###..###..#....#....#.##.#.#.#.#.#####..##....##.##.#....####.#..#...##.#..##.#...#.#.#.#
#....#...##.#.##..##.#.##..##.#.....#.##.#......#...#..###.#.###.###...#....#.#..###.###....##.###.##
#.##..##.#..#.#.##..#..#...##.###.#.##.....#########....#..###.#.#......#.#...####..#.#.#.#.#.##.#..#
#.#.###...##...#.#..#..####....####.#.#.##.#......##..##...#.#.#.##.#.#.#.####...#..#.#.######.#....#
##.##..#####..#.#..##..#..#.###..#...#.#..#.###.###..##..#.#.#.###.####.###..####..##..#..#..#.#..#.#
##.#.....#....#..#..#.#.###..##.#.##..#.##...###..####.##..#.##.##...###..##........##..##..##.#.####
##..#.#.#.###.####.##.##...#.###.#..###...#.##..##.#..#..#.#.#.#...#.#.####..##.######.##.#...#..##.#
##.#..#..##...##.#..###.#..##.#...##.##.##..##.#.#.....##....##..#...##.#.##..####..#.##...##..#.#.##
##.#..#..##.####...#..#.###...####.#..####.#.#..##.###.#..###..##....#.#..#..###.....#.#....####..#.#
#..##.####..##..##..#.##.#.##.#.##...#.#....##.###.#.#.#.##....#####.##.######..####..##.##...#..#..#
#...##..#.#.##.#..#.#.#.....#..###.##.#...##...#...###.#....#.##...##.#.#.##.#.#....###....##..#.####
#.##..#..###.#.##..#########..#.#..#..#####..##.#.#.##.#..#.####.#...##....#...#..####..####...#...##
#.#.##....#..##.#.##.#.#.#.....#.#..###.#..#.###..#.......###..##..#..###..####..#..#..##...#.##.#.##
##..##.####.#.#.#...#....####.##.#.##..##..#..#.###.#####......##.##.#.......###.###...####.##.#...##
##.#..#...#.##.#..#..##..##.#.#...#..#...##....#..#..##.#.####..#.##....###..#.....####.##..#.#..##.#
##..##..##..#...####.###...##..####..####.#.#.##.#####.#..##.#..#...######.#.##.#.#.#..##.##...##...#
##..#.###...#.#..#.###.#.#.#...#.#...#.#..###.##.#.#..#..#.###.#.##.##..##.#..######.#...#..#.##.##.#
##....#.#####.#...#......###..#..##..#.####....###.....#..#.##.#....#..##.#.##.....###....####......#
#..##.##...#.##.#..####..#.#####...##..#..#.###..##.#.#.#.#..###.###.#..#.##.#..#..#..###..##..##.#.#
###..#.#...###..#...#.##.#.###..#.##..#.####.##.#.#.#.#..#.###.#...#.###...##.###.##.#.#...###..#.###
##.##..#.###..###.##.#..#.#..###...#.#.#.#.........##.###....##....#..#..#..##...##.#.#.#.#.##.###..#
##.#...#...#.##.###.#.##...#.##.#.#.#..###.####.###.#.#..##.#.###.#..#.#.##...#.#.#..#..##...#...####
#..##..##.##.#..#..#..#.##.#....#.#...##..#..##....###.##..##..#..#...#.##..#..#...#.####..##.#..#..#
#####################################################################################################